NO textures/bluestone.xpm
SO textures/eagle.xpm
WE textures/greystone.xpm
EA textures/door.xpm

F 100,11  -32 ,18
C 67,165,215

              111111
              100001
              100001
              100001
              100001
       11111111000011111111
       10000000000000000001
       100000000N0000000001
       10000000000000000001
       11111111000011111111
              100001
              100001
              100001
              100001
              111111
         