NO textures/door.xpm    
SO textures/greystone.xpm
WE textures/bluestone.xpm
EA textures/eagle.xpm

F 220,100, 4, 4
C 225,30,0

11111111111111111
10000000000000001
10000000000000001
10000011110000001
10000011110000001
10000000000N00001
10000000000000001
11111111111111111