NO textures/ancientstone.xpm
SO textures/brick.xpm
EA textures/yellowstone.xpm
WE textures/greystone.xpm

C 146,141,244
F 136,46,45

11111111111111111111
100000000000000000001
1000000000000000000001
10000000000000000001111
10000011111000010101
10000010001000000001
100000100010000100011111
100000100010000000000001
100000110110000101010001
111110000000000000000001
    10000000000000000001
    10000N00000000000001
    10000000000000000001
   100000000000000000001
  1000000000000000000001
 10000000000000000000001
111111111000000000000001
110100001000000111111111
1100000010000001
1101000010000001
1101111110000001111
1100000000000000001
1111111110000000001
1111111111111111111